### 1048 Tags ###
CLD = "countries/Cloudsdale.txt"
CER = "countries/CentralEquestria.txt"
NER = "countries/NorthernEquestria.txt"
WHY = "countries/Whinnyapolis.txt"
BLS = "countries/Bales.txt"
AWR = "countries/AlbionWorkersRepublic.txt"
MWR = "countries/NewMirabelleWorkersRepublic.txt"
CWR = "countries/CrystalWorkersUnion.txt"
YAH = "countries/YahClique.txt"
SMH = "countries/SmushtonClique.txt"
VRG = "countries/VirgilsMarauders.txt"
SCH = "countries/Screechers.txt"
JGR = "countries/JanGrowlers.txt"
NVC = "countries/NovanCompound.txt"
CCA = "countries/Centralchangeling.txt"
NCA = "countries/Northernchangeling.txt"
SPF = "countries/SpaFreeState.txt"
STB = "countries/ArchEmpireOfStableside.txt"
NID = "countries/Nidhogg.txt"
MTS = "countries/MilitemSolar.txt"
EEE = "countries/YancuiliaCualometztli.txt"
NEI = "countries/NeighuaConfederation.txt"
NRP = "countries/NationalRedemptionPact.txt"
CLI = "countries/Clifford.txt"
SLW = "countries/SolarEmpireCivilWar.txt"
TRS = "countries/Trotsas.txt"
ALA = "countries/AppleLiberty.txt"

### Zebrican Nations for the future ###
#DIS = "countries/CultOfChaos.txt"
#GLB = "countries/GoldenBeacon.txt"
#RBZ = "countries/RebornZebricanEmpire.txt"
OAU = "countries/OrdoAustralis.txt"
DOH = "countries/DirectorateOfHippogriffia.txt"
HPS = "countries/HIPSOC.txt"
HRL = "countries/HippogriffianReclamationLeague.txt"
NZA = "countries/ColtzanianProtectorate.txt"
#HIE = "countries/HippogriffianExiles.txt"
#SRI = "countries/StormRiders.txt"
#SSW = "countries/SeaSwords.txt"
KAC = "countries/ThreeStripesMovement.txt"
KAP = "countries/Owobadi.txt"
KAF = "countries/SuhmaneseFreestate.txt"
KAW = "countries/EbonWatch.txt"
KAG = "countries/Ytrabad.txt"
KAD = "countries/KarkRepublic.txt"
ILU = "countries/Illuminate.txt"
NDR = "countries/NeighleRepublic.txt"
REM = "countries/Remudan.txt"
ZAJ = "countries/Zajharishat.txt"
AZI = "countries/Azir.txt"
CAM = "countries/Camelkeon.txt"
ZIT = "countries/Zitsan.txt"
TNT = "countries/Transnaartarl.txt"
HSO = "countries/Highstorm.txt"

### Zebrican Wasteland non-interactable country ###
#CHW = "countries/ChaoticWasteland.txt"